##########
#        #
# #      #
#  #     #
#   ##   #
#   ##   #
#     #  #
#      # #
#        #
##########